0,0,0,0,0,0,0,0,0,0,0,0,0,0,0,0,0,0,0,0
0,0,0,0,0,0,0,0,0,0,0,0,0,0,0,0,0,0,0,0
0,0,1,6,1,3,1,7,1,3,1,3,1,3,1,7,1,5,0,0
0,0,3,6,3,1,3,7,3,1,3,1,3,1,3,7,3,1,0,0
0,0,4,3,6,6,6,6,6,6,6,3,1,3,1,6,6,6,0,0
0,0,4,1,3,1,3,1,3,1,3,6,3,8,3,1,3,1,0,0
0,0,4,3,1,3,1,3,1,3,1,6,1,3,1,3,1,3,0,0
0,0,4,1,3,6,6,6,6,6,6,6,6,6,6,1,3,1,0,0
0,0,4,3,1,3,1,3,6,6,6,3,1,3,1,3,1,3,0,0
0,0,4,1,3,1,3,1,3,1,3,1,3,1,3,1,3,1,0,0
0,0,0,0,0,0,0,0,0,0,0,0,0,0,0,0,0,0,0,0
0,0,0,0,0,0,0,0,0,0,0,0,0,0,0,0,0,0,0,0
