0,0,0,0,0,0,0,0,0,0,0,0,0,0,0,0,0,0,0,0
0,0,0,0,0,0,0,0,0,0,0,0,0,0,0,0,0,0,0,0
0,0,6,6,3,1,3,6,6,3,1,3,1,3,1,3,1,3,0,0
0,0,6,6,1,3,1,6,6,1,3,1,3,1,3,1,3,1,0,0
0,0,6,6,3,1,3,6,6,3,1,3,1,3,1,3,1,3,0,0
0,0,6,6,6,6,6,6,6,1,3,1,3,1,3,1,3,1,0,0
0,0,6,6,6,6,6,6,6,3,1,3,1,3,5,3,1,3,0,0
0,0,1,3,1,3,1,6,6,1,3,1,3,1,3,1,3,1,0,0
0,0,3,1,3,1,3,6,6,3,1,3,1,3,1,3,1,3,0,0
0,0,1,3,1,3,1,6,6,1,3,1,3,1,3,1,3,1,0,0
0,0,0,0,0,0,0,0,0,0,0,0,0,0,0,0,0,0,0,0
0,0,0,0,0,0,0,0,0,0,0,0,0,0,0,0,0,0,0,0
