0,0,0,0,0,0,0,0,0,0,0,0,0,0,0,0,0,0,0,0
0,0,0,0,0,0,0,0,0,0,0,0,0,0,0,0,0,0,0,0
0,0,1,3,1,4,1,3,1,3,1,4,1,3,1,3,1,3,0,0
0,0,3,1,3,4,3,1,4,1,3,4,3,4,4,1,3,1,0,0
0,0,4,3,1,4,1,3,4,3,1,4,1,4,4,5,1,3,0,0
0,0,4,1,3,4,3,1,4,1,3,1,3,4,4,1,3,1,0,0
0,0,4,3,1,4,5,3,4,3,1,3,4,4,4,3,1,3,0,0
0,0,4,1,3,4,3,1,4,1,3,1,4,4,4,4,4,4,0,0
0,0,4,3,1,4,1,3,4,3,1,3,4,4,4,4,4,4,0,0
0,0,4,1,3,1,3,1,4,4,4,4,4,4,4,4,4,4,0,0
0,0,0,0,0,0,0,0,0,0,0,0,0,0,0,0,0,0,0,0
0,0,0,0,0,0,0,0,0,0,0,0,0,0,0,0,0,0,0,0
