0,0,0,0,0,0,0,0,0,0,0,0,0,0,0,0,0,0,0,0
0,0,0,0,0,0,0,0,0,0,0,0,0,0,0,0,0,0,0,0
0,0,1,8,8,8,8,8,8,8,1,3,1,3,1,3,1,3,0,0
0,0,3,8,8,8,8,8,8,8,3,1,3,1,3,1,3,1,0,0
0,0,1,3,1,3,1,3,8,8,1,3,1,3,1,3,1,3,0,0
0,0,3,1,8,8,8,8,8,8,3,1,3,1,3,1,5,1,0,0
0,0,1,3,8,8,8,8,8,8,1,3,1,3,1,3,1,3,0,0
0,0,3,1,3,1,3,1,8,8,3,1,3,1,3,1,3,1,0,0
0,0,1,8,8,8,8,8,8,8,1,3,1,3,1,3,1,3,0,0
0,0,3,8,8,8,8,8,8,8,3,1,3,1,3,1,3,1,0,0
0,0,0,0,0,0,0,0,0,0,0,0,0,0,0,0,0,0,0,0
0,0,0,0,0,0,0,0,0,0,0,0,0,0,0,0,0,0,0,0
