0,0,0,0,0,0,0,0,0,0,0,0,0,0,0,0,0,0,0,0
0,0,0,0,0,0,0,0,0,0,0,0,0,0,0,0,0,0,0,0
0,0,1,6,1,3,6,3,5,3,1,3,1,3,1,6,1,3,0,0
0,0,3,6,3,1,6,1,3,1,4,4,3,1,4,4,6,1,0,0
0,0,1,6,1,3,6,6,6,6,6,6,1,3,1,3,6,3,0,0
0,0,3,6,3,1,3,1,3,1,3,1,6,1,3,1,6,1,0,0
0,0,1,6,1,3,6,6,6,6,1,3,6,4,1,3,6,3,0,0
0,0,3,6,3,1,3,1,3,6,3,1,6,1,3,1,6,1,0,0
0,0,1,6,1,3,1,3,1,3,6,6,1,3,1,3,6,3,0,0
0,0,3,1,6,1,3,1,3,1,3,1,3,1,6,6,3,1,0,0
0,0,0,0,0,0,0,0,0,0,0,0,0,0,0,0,0,0,0,0
0,0,0,0,0,0,0,0,0,0,0,0,0,0,0,0,0,0,0,0
