0,0,0,0,0,0,0,0,0,0,0,0,0,0,0,0,0,0,0,0
0,0,0,0,0,0,0,0,0,0,0,0,0,0,0,0,0,0,0,0
0,0,1,3,1,3,1,3,1,3,1,3,1,3,1,3,1,3,0,0
0,0,3,1,3,1,3,1,3,8,3,8,3,1,3,1,3,1,0,0
0,0,1,3,1,3,6,3,1,3,1,3,1,2,1,5,1,3,0,0
0,0,3,1,3,6,4,1,3,1,3,1,3,2,3,1,3,1,0,0
0,0,1,3,1,6,4,3,1,3,1,3,1,2,1,3,1,3,0,0
0,0,3,1,3,1,6,1,3,1,3,1,3,2,3,1,3,1,0,0
0,0,1,3,1,3,1,3,1,7,7,7,7,3,1,3,1,3,0,0
0,0,3,1,3,1,3,1,3,1,3,1,3,1,3,1,3,1,0,0
0,0,0,0,0,0,0,0,0,0,0,0,0,0,0,0,0,0,0,0
0,0,0,0,0,0,0,0,0,0,0,0,0,0,0,0,0,0,0,0
