0,0,0,0,0,0,0,0,0,0,0,0,0,0,0,0,0,0,0,0
0,0,0,0,0,0,0,0,0,0,0,0,0,0,0,0,0,0,0,0
0,0,1,3,1,3,7,3,1,3,1,3,1,3,7,3,1,3,0,0
0,0,3,1,3,1,7,1,3,1,3,1,3,1,7,1,3,1,0,0
0,0,1,3,1,3,7,3,1,3,1,3,1,3,7,4,5,3,0,0
0,0,7,7,7,7,7,1,3,1,3,1,3,1,7,4,4,1,0,0
0,0,1,3,1,3,1,3,1,3,1,3,1,3,1,7,7,7,0,0
0,0,3,1,3,1,3,1,6,6,6,1,3,1,3,1,3,1,0,0
0,0,1,3,1,3,1,4,1,8,1,4,1,3,1,3,1,3,0,0
0,0,3,1,3,1,3,1,3,1,3,1,3,1,3,1,3,1,0,0
0,0,0,0,0,0,0,0,0,0,0,0,0,0,0,0,0,0,0,0
0,0,0,0,0,0,0,0,0,0,0,0,0,0,0,0,0,0,0,0
