0,0,0,0,0,0,0,0,0,0,0,0,0,0,0,0,0,0,0,0
0,0,0,0,0,0,0,0,0,0,0,0,0,0,0,0,0,0,0,0
0,0,1,3,1,3,1,3,1,3,1,3,1,3,1,3,1,3,0,0
0,0,7,7,7,7,3,1,3,1,3,1,3,1,3,1,3,1,0,0
0,0,7,3,1,7,1,3,1,3,1,3,1,3,5,3,1,3,0,0
0,0,3,1,3,7,3,1,3,1,3,1,3,1,3,1,3,1,0,0
0,0,7,7,7,7,1,3,1,3,1,3,1,3,1,3,1,3,0,0
0,0,7,1,3,1,3,1,3,1,3,1,3,1,3,1,3,1,0,0
0,0,7,7,7,7,1,3,1,3,1,3,1,3,1,3,1,3,0,0
0,0,3,1,3,1,3,1,3,1,3,1,3,1,3,1,3,1,0,0
0,0,0,0,0,0,0,0,0,0,0,0,0,0,0,0,0,0,0,0
0,0,0,0,0,0,0,0,0,0,0,0,0,0,0,0,0,0,0,0
