0,0,0,0,0,0,0,0,0,0,0,0,0,0,0,0,0,0,0,0
0,0,0,0,0,0,0,0,0,0,0,0,0,0,0,0,0,0,0,0
0,0,1,6,1,3,1,3,1,8,1,2,1,3,1,3,1,3,0,0
0,0,3,6,3,1,3,1,3,1,3,2,3,1,4,1,3,1,0,0
0,0,1,6,1,3,1,3,6,6,6,6,4,4,4,3,1,3,0,0
0,0,3,6,3,1,3,1,6,1,3,4,3,1,3,1,3,4,0,0
0,0,1,6,1,3,1,3,6,3,1,4,1,3,1,3,1,4,0,0
0,0,3,6,3,1,3,1,3,7,7,4,3,1,4,4,4,1,0,0
0,0,1,6,1,3,1,3,1,3,1,4,1,3,1,7,1,5,0,0
0,0,3,6,3,1,3,1,3,1,3,4,3,1,3,7,3,1,0,0
0,0,0,0,0,0,0,0,0,0,0,0,0,0,0,0,0,0,0,0
0,0,0,0,0,0,0,0,0,0,0,0,0,0,0,0,0,0,0,0
